NO ./north.xpm
SO ./south.xpm
WE ./west.xpm
EA ./east.xpm
F 220,100,0
C 225,30,0
11111
10 N1
11111